E0001110000000100100
11100011101110001111
11111000101000111000
00001110001100010010
01011000101111000110
